; level 0
w9
h7
#########
# #.$. *#
#@$    ##
# #$$ $ #
##  *# ##
###.. .##
#########

; level 1
w9
h7
#########
# ##@## #
#..$$##.#
# #  $ .#
#*# $   #
# ###  ##
#########

; level 2
w9
h7
#########
### # # #
##+$  ..#
# *#$$$.#
#* #.$ $#
##**.   #
#########

; level 3
w5
h5
#####
#@###
#$###
#.###
#####
