; level 0
w9
h7
#########
# #.$. *#
#@$    ##
# #$$ $ #
##  *# ##
###.. .##
#########

; level 1
w9
h7
#########
# ##@## #
#..$$##.#
# #  $ .#
#*# $   #
# ###  ##
#########

; level 2
w9
h7
#########
### # # #
##+$  ..#
# *#$$$.#
#* #.$ $#
##**.   #
#########

; level 3
w5
h5
#####
#@###
#$###
#.###
#####

; level 4
w15
h14
###############
####       ####
###  $ $ $  ###
##  $ $ $ $  ##
## $ #...# $ ##
##  ###.###  ##
## $ #...# $ ##
##  $..#..$  ##
## $ *.#.* $ ##
##  $..#..$  ##
###  #. .#  ###
### $ ### $ ###
####   @   ####
###############

; level 5
w10
h10
##########
# ..#  ###
# ..# $###
#  ##    #
## $   $ #
## ##  ###
##   $####
####  ####
####@ ####
##########

; level 6
w9
h7
#########
##     ##
#  . $ @#
# $*$$. #
# $..$. #
# $..$. #
#########

; level 7
w7
h11
#######
# $.  #
# *   #
# *   #
# *** #
#   * #
##  * #
### * #
### * #
#### @#
#######


